15 15 15 15 15 15 15 15 15 15 15 15 15 15 15 15 15 15 15 15 15 15 15 15 15 15 15 15 15 15 15 15 15 15 15 15 15 15 15 15 15 15 15 15 15 15 15 15 15 15 
15 15 17 17 17 17 17 17 17 17 17 17 17 17 17 15 15 15 15 15 15 17 17 17 17 17 17 17 17 17 17 17 15 15 17 17 17 17 17 17 17 17 17 17 17 17 17 17 15 15 
15 21 1 1 1 1 1 1 1 1 1 1 1 1 1 20 15 15 15 15 21 1 1 1 1 1 1 1 1 1 1 1 20 21 1 1 1 1 1 1 1 1 1 1 1 1 1 1 20 15 
15 21 1 12 11 11 11 11 11 11 11 11 11 13 1 20 15 15 15 15 21 1 12 11 11 11 11 11 11 11 13 1 20 21 1 12 11 11 11 11 11 11 11 11 13 1 1 1 20 15 
15 21 1 9 4 4 4 8 4 8 4 8 4 10 1 20 15 15 15 15 21 1 9 4 8 4 8 4 8 4 10 1 20 21 1 9 4 8 4 8 4 8 4 4 10 1 1 1 20 15 
15 21 1 9 4 14 4 4 5 5 5 4 4 10 1 20 15 15 15 15 21 1 9 14 4 5 5 5 4 14 10 1 20 21 1 9 14 4 5 5 4 4 14 4 10 1 1 1 20 15 
15 21 1 9 4 4 4 10 1 1 1 9 14 10 1 20 15 15 15 15 21 1 9 4 10 1 1 1 9 4 10 1 20 21 1 9 4 10 23 24 9 4 4 4 10 1 1 1 20 15 
15 21 1 9 4 14 4 10 1 22 1 9 4 10 1 20 15 15 15 15 21 1 9 14 10 1 15 1 9 14 10 1 20 21 1 9 14 10 20 21 9 4 14 4 10 0 0 1 20 15 
15 21 1 9 4 4 4 10 1 15 1 9 14 10 1 20 15 15 15 15 21 1 9 4 10 1 15 1 9 4 10 1 20 21 1 9 4 10 20 21 9 4 4 4 10 1 0 1 20 15 
15 21 1 9 4 14 4 10 1 15 1 9 4 10 1 20 15 15 15 15 21 1 9 14 10 1 15 1 9 14 10 1 20 21 1 9 14 10 20 21 9 4 14 4 10 1 0 1 20 15 
15 21 1 9 4 4 4 10 1 15 1 9 14 10 1 20 15 15 15 15 21 1 9 4 10 1 15 1 9 4 10 1 20 21 1 9 4 10 20 21 9 4 4 4 10 1 0 1 20 15 
15 21 1 9 4 14 4 10 1 15 1 9 4 10 1 20 15 15 15 15 21 1 9 14 10 1 15 1 9 14 10 1 20 21 1 9 14 10 0 0 9 4 14 4 10 1 0 1 20 15 
15 21 1 9 4 4 4 10 1 15 1 9 14 10 1 20 15 15 15 15 21 1 9 4 10 1 15 1 9 4 10 1 20 21 1 9 4 10 20 21 9 4 4 4 10 1 0 1 20 15 
15 21 1 9 4 14 4 10 1 15 1 9 4 10 1 20 15 15 15 15 21 1 9 14 10 1 15 1 9 14 10 1 20 21 1 9 14 10 20 21 9 4 14 4 10 1 0 1 20 15 
15 21 1 9 4 4 4 10 1 15 1 9 14 10 1 20 15 15 15 15 21 1 9 4 10 1 15 1 9 4 10 1 20 21 1 9 4 10 20 21 9 4 4 4 10 0 0 1 20 15 
15 21 1 9 4 14 4 10 1 15 1 9 4 10 1 20 15 15 15 15 21 1 9 14 10 1 15 1 9 14 10 1 20 21 1 9 14 10 20 21 9 4 14 4 10 1 1 1 20 15 
15 21 1 9 4 4 4 10 1 15 1 9 14 10 1 20 15 15 15 15 21 1 9 4 10 1 15 1 9 4 10 1 20 21 1 9 4 10 20 21 9 4 4 4 10 1 1 1 20 15 
15 21 1 9 4 14 4 10 1 15 1 9 4 10 1 20 15 15 15 15 21 1 9 14 10 1 15 1 9 14 10 1 20 21 1 9 14 10 20 21 9 4 14 4 10 1 1 1 20 15 
15 21 1 9 4 4 4 10 1 15 1 9 14 10 1 20 15 15 15 15 21 1 9 4 10 1 15 1 9 4 10 1 20 21 1 9 4 10 20 21 9 4 4 4 10 1 1 1 20 15 
15 21 1 9 4 14 4 10 1 15 1 9 4 10 1 20 15 15 15 15 21 1 9 14 10 1 15 1 9 14 10 1 20 21 1 9 14 10 20 21 9 4 14 4 10 1 1 1 20 15 
15 21 1 9 4 4 4 10 1 15 1 9 14 10 1 20 15 15 15 15 21 1 9 4 10 1 15 1 9 4 10 1 20 21 1 9 4 10 20 21 9 4 4 4 10 1 1 1 20 15 
15 21 1 9 4 14 4 10 1 15 1 9 4 10 1 20 15 15 15 15 21 1 9 14 10 1 15 1 9 14 10 1 20 21 1 9 14 10 20 21 9 4 14 4 10 1 1 1 20 15 
15 21 1 9 4 4 4 10 1 15 1 9 14 10 1 20 15 15 15 15 21 1 9 4 10 1 15 1 9 4 10 1 20 21 1 9 4 10 20 21 9 4 4 4 10 1 1 1 20 15 
15 21 1 9 4 14 4 10 1 15 1 9 4 10 1 18 17 17 17 17 19 1 9 14 10 1 15 1 9 14 10 1 18 19 1 9 14 10 20 21 9 4 14 4 10 1 1 1 20 15 
15 21 1 9 4 4 4 10 1 15 1 9 14 10 1 1 1 1 1 1 1 1 9 4 10 1 15 1 9 4 10 1 1 1 1 9 4 10 20 21 9 4 4 4 10 1 1 1 20 15 
15 21 1 9 4 14 4 10 1 15 1 9 4 4 11 11 11 11 11 11 11 11 4 14 10 1 1 1 9 14 4 11 11 11 11 4 14 10 20 21 9 4 14 4 10 1 1 1 20 15 
15 21 1 9 4 4 4 10 1 15 1 9 4 8 4 8 4 8 4 8 4 8 4 4 10 0 0 0 9 4 4 8 4 8 4 8 4 10 20 21 9 4 4 4 10 1 1 1 20 15 
15 21 1 9 4 14 4 10 1 15 1 6 5 5 5 5 5 5 5 5 5 5 5 5 7 1 1 1 6 5 5 5 5 5 5 5 5 7 20 21 9 4 14 4 10 1 1 1 20 15 
15 21 1 9 4 4 4 10 1 15 1 1 1 1 1 1 1 1 1 1 1 1 1 1 1 1 1 1 1 1 1 1 1 1 1 1 1 1 20 21 9 4 4 4 10 1 1 1 20 15 
15 21 1 9 4 14 4 10 1 15 22 22 22 22 22 22 22 22 22 22 22 22 22 22 22 22 22 22 22 22 22 22 22 22 22 22 22 22 15 21 9 4 14 4 10 1 1 1 20 15 
15 21 1 9 4 4 4 10 1 20 15 15 15 15 15 15 15 15 15 15 15 15 15 15 15 15 15 15 15 15 15 15 15 15 15 15 15 15 15 21 9 4 4 4 10 1 1 1 20 15 
15 21 1 9 4 14 4 10 1 20 15 15 15 15 15 15 15 15 15 15 15 15 15 15 15 15 15 15 15 15 15 15 15 15 15 15 15 15 15 21 9 4 14 4 10 1 1 1 20 15 
15 21 1 9 4 4 4 10 1 20 15 17 17 17 17 17 17 17 17 17 17 17 17 17 17 17 17 17 17 17 17 17 17 17 17 17 17 17 17 19 9 4 4 4 10 1 1 1 20 15 
15 21 1 9 4 14 4 10 1 20 21 1 1 1 1 1 1 1 1 1 1 1 1 1 1 1 1 1 1 1 1 1 1 1 3 1 3 1 3 1 9 4 14 4 10 1 1 1 20 15 
15 21 1 9 4 4 4 10 1 20 21 1 12 11 11 11 11 11 11 11 11 11 11 11 11 11 11 11 11 11 11 11 11 11 11 11 11 11 11 11 4 4 4 4 10 1 1 1 20 15 
15 21 1 9 4 14 4 10 1 20 21 1 9 4 4 4 4 4 4 4 4 4 4 4 4 4 4 4 4 4 4 4 4 4 4 4 4 4 4 4 4 4 14 4 10 1 1 1 20 15 
15 21 1 9 4 4 4 10 1 20 21 1 9 4 4 8 4 8 4 8 4 8 4 8 4 8 4 8 4 8 4 8 4 8 4 8 4 8 4 8 4 4 4 4 10 1 1 1 20 15 
15 21 1 9 4 14 4 10 1 20 21 1 9 14 4 4 4 4 4 4 4 4 4 4 4 4 4 4 4 4 4 4 4 4 4 4 4 4 4 4 4 4 4 4 10 1 1 1 20 15 
15 21 1 9 4 4 4 10 1 20 21 1 9 4 4 5 5 5 5 5 5 5 5 5 5 5 5 5 5 5 5 5 5 5 5 5 5 5 5 5 5 4 4 5 7 1 1 1 20 15 
15 21 1 9 4 14 4 10 0 0 0 0 9 14 10 1 1 1 1 1 1 1 0 1 1 1 1 1 1 0 1 1 1 1 1 1 1 1 1 1 1 9 10 1 1 1 1 1 20 15 
15 21 1 9 4 4 4 10 1 20 21 1 9 4 10 1 1 1 1 1 1 1 0 1 1 1 1 1 1 0 1 1 1 1 1 1 1 1 1 1 1 9 4 11 11 11 13 1 20 15 
15 21 1 9 4 14 4 10 1 20 21 1 9 14 10 1 1 1 1 1 1 1 0 1 1 1 1 1 1 0 1 1 1 1 1 1 1 1 1 1 1 9 4 4 4 4 10 1 20 15 
15 21 1 9 4 4 4 10 1 18 19 1 9 4 10 1 1 1 1 1 1 1 0 0 0 0 0 0 0 0 1 1 1 1 1 1 1 1 1 1 1 9 4 4 4 4 10 1 20 15 
15 21 1 9 4 14 4 10 1 1 1 1 9 14 10 1 1 1 1 1 1 1 1 1 1 1 1 1 1 1 1 1 1 1 1 1 1 1 1 1 1 9 4 4 4 4 10 1 20 15 
15 21 1 9 4 4 4 4 11 11 11 11 4 4 10 1 1 1 1 1 1 1 1 1 1 1 1 1 1 1 1 1 1 1 1 1 1 1 1 1 1 9 4 4 4 4 10 1 20 15 
15 21 1 9 4 14 4 8 4 8 4 8 4 8 10 1 1 1 1 1 1 1 1 1 1 1 1 1 1 1 1 1 1 1 1 1 1 1 1 1 1 6 5 5 5 5 7 1 20 15 
15 21 1 6 5 5 5 5 5 5 5 5 5 5 7 1 1 1 1 1 1 1 1 1 1 1 1 1 1 1 1 1 1 1 1 1 1 1 1 1 1 1 1 1 1 1 1 1 20 15 
15 21 1 1 1 1 1 1 1 1 1 1 1 1 1 1 1 1 1 1 1 1 1 1 1 1 1 1 1 1 1 1 1 1 1 1 1 1 1 1 1 1 1 1 1 1 1 1 20 15 
15 15 22 22 22 22 22 22 22 22 22 22 22 22 22 22 22 22 22 22 22 22 22 22 22 22 22 22 22 22 22 22 22 22 22 22 22 22 22 22 22 22 22 22 22 22 22 22 15 15 
15 15 15 15 15 15 15 15 15 15 15 15 15 15 15 15 15 15 15 15 15 15 15 15 15 15 15 15 15 15 15 15 15 15 15 15 15 15 15 15 15 15 15 15 15 15 15 15 15 15 
