16 15 15 15 16 15 15 15 16 15 15 16 15 15 15 15 16 15 15 16 15 16 15 15 15 16 15 15 16 15 15 15 16 15 15 15 16 15 15 15 15 15 16 15 15 15 15 16 15 15 
15 15 17 17 17 17 17 17 17 17 17 17 17 17 17 15 15 15 15 15 15 17 17 17 17 17 17 17 17 17 17 17 15 15 17 17 17 17 17 17 17 17 17 17 17 17 17 17 15 15 
15 21 1 2 1 1 1 2 1 1 1 2 2 1 1 20 16 15 15 15 21 1 2 1 1 2 1 2 1 1 1 1 20 21 1 1 1 1 1 1 1 1 1 1 1 1 1 1 20 15 
15 21 1 12 11 11 11 11 11 11 11 11 11 13 1 20 15 15 15 15 21 1 12 11 11 11 11 11 11 11 13 2 20 21 2 12 11 11 11 11 11 11 11 11 13 1 1 1 20 16 
15 21 1 9 4 4 4 8 4 8 4 8 4 10 1 20 15 15 16 15 21 1 9 4 8 4 8 4 8 4 10 1 20 21 1 9 4 8 4 8 4 8 4 4 10 1 2 1 20 15 
16 21 2 9 4 14 4 5 5 5 5 4 4 10 1 20 15 15 15 15 21 1 9 14 4 5 5 5 4 14 10 1 20 21 1 9 14 4 5 5 4 4 14 4 10 1 1 2 20 15 
15 21 1 9 4 4 10 2 1 2 1 9 14 10 1 20 16 15 15 15 21 2 9 4 10 1 1 1 9 4 10 2 20 21 1 9 4 10 23 24 9 4 4 4 10 1 1 1 20 16 
15 21 1 9 4 14 10 23 22 24 1 9 4 10 2 20 15 15 15 15 21 1 9 14 10 1 22 2 9 14 10 1 20 21 2 9 14 10 20 21 9 4 14 4 10 0 0 1 20 15 
15 21 2 9 4 4 10 20 15 21 2 9 14 10 1 20 15 15 16 15 21 1 9 4 10 1 15 1 9 4 10 1 20 21 1 9 4 10 20 21 9 4 4 4 10 1 0 1 20 16 
16 21 1 9 4 14 10 20 16 21 1 9 4 10 1 20 15 15 15 15 21 2 9 14 10 2 16 1 9 14 10 1 20 21 1 9 14 10 20 21 9 4 14 4 10 1 0 1 20 15 
15 21 2 9 4 4 10 20 15 21 1 9 14 10 1 20 15 15 15 15 21 1 9 4 10 1 15 1 9 4 10 2 20 21 2 9 4 10 20 21 9 4 4 4 10 2 0 1 20 15 
15 21 1 9 4 14 10 20 15 21 1 9 4 10 1 20 15 16 15 15 21 1 9 14 10 1 15 1 9 14 10 1 20 21 1 9 14 10 0 0 9 4 14 4 10 1 0 1 20 16 
15 21 1 9 4 4 10 20 16 21 1 9 14 10 2 20 15 15 15 15 21 1 9 4 10 1 15 1 9 4 10 1 20 21 2 9 4 10 20 21 9 4 4 4 10 1 0 1 20 15 
15 21 1 9 4 14 10 20 15 21 2 9 4 10 1 20 15 15 16 15 21 2 9 14 10 1 16 1 9 14 10 1 20 21 1 9 14 10 20 21 9 4 14 4 10 1 0 2 20 15 
16 21 2 9 4 4 10 20 15 21 1 9 14 10 1 20 15 15 15 15 21 1 9 4 10 1 15 1 9 4 10 1 20 21 1 9 4 10 20 21 9 4 4 4 10 0 0 1 20 16 
15 21 1 9 4 14 10 20 16 21 1 9 4 10 1 20 15 15 15 15 21 1 9 14 10 1 15 1 9 14 10 1 20 21 1 9 14 10 20 21 9 4 14 4 10 1 1 1 20 15 
15 21 1 9 4 4 10 20 15 21 1 9 14 10 1 20 16 15 15 15 21 2 9 4 10 2 16 1 9 4 10 1 20 21 2 9 4 10 20 21 9 4 4 4 10 1 1 2 20 15 
15 21 1 9 4 14 10 20 15 21 1 9 4 10 2 20 15 15 15 16 21 1 9 14 10 1 15 2 9 14 10 2 20 21 1 9 14 10 20 21 9 4 14 4 10 23 22 22 15 15 
16 21 2 9 4 4 10 20 16 21 1 9 14 10 1 20 15 15 15 15 21 1 9 4 10 1 15 1 9 4 10 1 20 21 1 9 4 10 20 21 9 4 4 4 10 20 15 16 15 15 
15 21 1 9 4 14 10 20 15 21 2 9 4 10 1 20 15 16 15 15 21 1 9 14 10 2 16 1 9 14 10 1 20 21 1 9 14 10 20 21 9 4 14 4 10 20 15 15 15 16 
15 21 1 9 4 4 10 20 15 21 1 9 14 10 1 20 15 15 15 15 21 2 9 4 10 1 15 1 9 4 10 2 20 21 2 9 4 10 20 21 9 4 4 4 10 20 15 15 15 15 
15 21 1 9 4 14 10 20 16 21 1 9 4 10 2 20 15 15 16 15 21 1 9 14 10 1 15 1 9 14 10 1 20 21 1 9 14 10 20 21 9 4 14 4 10 20 16 15 15 15 
15 21 2 9 4 4 10 20 15 21 1 9 14 10 1 20 16 15 15 15 21 2 9 4 10 1 15 1 9 4 10 1 20 21 1 9 4 10 20 21 9 4 4 4 10 20 15 15 15 15 
16 21 1 9 4 14 10 20 16 21 1 9 4 10 1 18 17 17 17 17 19 1 9 14 10 1 16 2 9 14 10 1 18 19 2 9 14 10 20 21 9 4 14 4 10 20 15 16 15 15 
15 21 1 9 4 4 10 20 15 21 1 9 14 10 1 1 2 1 1 2 1 1 9 4 10 2 15 1 9 4 10 1 1 2 1 9 4 10 20 21 9 4 4 4 10 20 15 15 15 16 
15 21 1 9 4 14 10 20 15 21 1 9 4 4 11 11 11 11 11 11 11 11 4 14 10 1 17 1 9 14 4 11 11 11 11 4 14 10 20 21 9 4 14 4 10 20 16 15 15 15 
15 21 1 9 4 4 10 20 15 21 2 9 4 8 4 8 4 8 4 8 4 8 4 4 10 0 0 0 9 4 4 8 4 8 4 8 4 10 20 21 9 4 4 4 10 20 15 15 15 15 
15 21 2 9 4 14 10 20 16 21 1 6 5 5 5 5 5 5 5 5 5 5 5 5 7 2 22 1 6 5 5 5 5 5 5 5 5 7 20 21 9 4 14 4 10 20 15 15 15 15 
16 21 1 9 4 4 10 20 15 21 1 1 1 2 1 1 1 1 1 2 1 1 1 1 2 1 15 1 1 1 1 2 1 1 1 1 1 1 20 21 9 4 4 4 10 20 15 16 15 16 
15 21 1 9 4 14 10 20 15 15 22 22 22 22 22 22 22 22 22 22 22 22 22 22 22 22 15 22 22 22 22 22 22 22 22 22 22 22 15 21 9 4 14 4 10 20 15 15 15 15 
15 21 2 9 4 4 10 18 17 15 15 15 16 15 15 15 15 15 15 15 16 15 15 15 15 16 15 15 15 15 15 15 15 15 16 15 15 15 15 21 9 4 4 4 10 20 15 15 15 15 
15 21 2 9 4 14 4 13 1 20 15 15 15 15 16 15 15 16 15 15 15 15 15 15 15 15 15 15 16 15 15 15 15 15 15 15 15 16 15 21 9 4 14 4 10 20 16 15 15 15 
15 21 2 9 4 4 4 10 1 20 15 17 17 17 17 17 17 17 17 17 17 17 17 17 17 17 17 17 17 17 17 17 17 17 17 17 17 17 17 19 9 4 4 4 10 20 15 15 15 16 
16 21 1 9 4 14 4 10 1 20 21 1 1 1 1 1 1 1 1 1 1 1 1 1 1 1 1 1 1 1 1 1 1 1 3 1 3 1 3 1 9 4 14 4 10 20 15 16 15 15 
15 21 1 9 4 4 4 10 1 20 21 1 12 11 11 11 11 11 11 11 11 11 11 11 11 11 11 11 11 11 11 11 11 11 11 11 11 11 11 11 4 4 4 4 10 20 15 15 15 15 
15 21 1 9 4 14 4 10 1 20 21 1 9 4 4 4 4 4 4 4 4 4 4 4 4 4 4 4 4 4 4 4 4 4 4 4 4 4 4 4 4 4 14 4 10 18 17 17 15 15 
15 21 2 9 4 4 4 10 1 20 21 1 9 4 4 8 4 8 4 8 4 8 4 8 4 8 4 8 4 8 4 8 4 8 4 8 4 8 4 8 4 4 4 4 10 1 2 1 20 16 
15 21 1 9 4 14 4 10 1 20 21 2 9 14 4 4 4 4 4 4 4 4 4 4 4 4 4 4 4 4 4 4 4 4 4 4 4 4 4 4 4 4 4 4 10 1 1 1 20 15 
16 21 1 9 4 4 4 10 1 20 21 1 9 4 4 5 5 5 5 5 5 5 5 5 5 5 5 5 5 5 5 5 5 5 5 5 5 5 5 5 5 4 4 5 7 1 1 1 20 15 
15 21 1 9 4 14 4 10 0 0 0 0 9 14 10 1 1 1 1 1 1 1 0 1 1 1 1 1 1 0 1 1 1 1 1 1 1 1 1 1 1 9 10 1 1 1 1 1 20 15 
15 21 2 9 4 4 4 10 1 20 21 1 9 4 10 1 2 1 1 1 1 1 0 1 1 2 1 1 1 0 1 1 1 1 1 1 1 1 1 1 1 9 4 11 11 11 13 1 20 16 
15 21 1 9 4 14 4 10 1 20 21 1 9 14 10 1 1 1 1 1 1 1 0 1 1 1 1 1 1 0 1 1 1 1 1 1 1 1 2 1 1 9 4 4 4 4 10 1 20 15 
16 21 1 9 4 4 4 10 1 18 19 1 9 4 10 1 1 1 2 1 1 1 0 0 0 0 0 0 0 0 1 1 1 2 1 1 1 1 1 1 1 9 4 4 4 4 10 1 20 15 
15 21 2 9 4 14 4 10 1 2 2 1 9 14 10 1 1 1 1 1 1 1 1 1 1 1 1 1 1 1 1 1 1 1 1 1 1 1 1 1 1 9 4 4 4 4 10 1 20 16 
15 21 1 9 4 4 4 4 11 11 11 11 4 4 10 1 1 2 1 1 1 2 1 1 1 1 1 1 1 1 2 1 1 1 1 1 1 1 1 1 1 9 4 4 4 4 10 1 20 15 
15 21 1 9 4 14 4 8 4 8 4 8 4 8 10 1 1 1 1 1 1 1 1 1 1 1 1 2 1 1 1 1 1 1 1 1 2 1 1 1 1 6 5 5 5 5 7 1 20 15 
15 21 1 6 5 5 5 5 5 5 5 5 5 5 7 1 1 1 1 1 2 1 1 1 2 1 1 1 1 1 1 1 1 2 1 1 1 1 1 1 1 1 1 1 1 1 1 1 20 16 
16 21 1 2 1 1 1 1 1 1 2 1 1 1 2 1 1 1 1 1 1 1 1 1 1 1 1 1 1 1 1 1 1 1 1 1 1 1 1 1 1 2 1 1 1 1 1 1 20 15 
15 15 22 22 22 22 22 22 22 22 22 22 22 22 22 22 22 22 22 22 22 22 22 22 22 22 22 22 22 22 22 22 22 22 22 22 22 22 22 22 22 22 22 22 22 22 22 22 15 16 
15 15 15 16 15 15 15 15 15 15 15 16 15 15 16 15 15 15 15 15 15 16 15 15 15 15 15 16 15 15 15 15 15 15 16 15 15 15 16 15 15 15 15 16 15 15 16 15 15 15 
